        #####
       #  #  #
       #  O  #
        #   #
        #   #
        #   #
        #   #
        #   #
      ##     ##
     #    X    #
     # P       #
      #   #   #
       ### ###