        #####
       ###O###
       #     #
        #   #
        #   #
        #   #
        #   #
        # X #
      #########
     #    #    #
     # P  #    #
      #   #   #
       #######
                       
