#####
#P###
# ###
# ###
# ###
#  ##
## ##
## ##
## ##
##  #
##  #
### #
### #
### #
### #
### #
#    #
#     #
#      #
#       #
#        #
#      X  #
#          #
#           #
#            #
#             #
#      O       #
#################
