########################
#           X         O#
#           X    #######
#  X  P   O      #
#                #
#   O       X    #
##################
